##################################################
#@....#...........................#..............#
#.....#............#..............#..............#
#..................#...############..............#
#######............#...#.........................#
#..................#####.........................#
#................................................#
#................................................#
#.................................################
#....############................................#
#...............#................#...............#
#....#..........#................#...............#
#....#..........#................#################
#....#..........#................................#
#....#..........#................................#
#....############................................#
#........................##########..............#
#........................#.......................#
#........................#........#..............#
#........................#........#..............#
##################################################