##################################################
#.................................#..............#
#..................#..............#..............#
#..................#...############..............#
#######............#...#.........................#
#.....#............#####.........................#
#.....#..........................................#
#.....#..........................................#
#.....#..........................................#
#.....#..........................................#
#...............##############...#################
#.####..........#................................#
#....#....@.....#................#################
#....#..........#................................#
#....#..........#................................#
#....#...........................................#
#....#...................##########..............#
#....#...................#.......................#
#....#...................#........#..............#
#....#...................#........#..............#
##################################################