##################################################
#.....#...........................#..............#
#.....#............#..............#..............#
#..................#...############..............#
#######............#...#.........................#
#..................#####.........................#
#................................................#
#................................................#
#........#########################################
#................................................#
#...#################...........@................#
#...................#............................#
#...................##############################
#................................................#
#................................................#
#....############................................#
#....#..........#........##########..............#
#....#..........#........#.......................#
#....#..........#........#........#..............#
#....#...................#........#..............#
##################################################